75  47
11 40
 0  0  0  0  0  0  0  0  0  0  0  0  0  0  0  0  0  0  0  0  0  0  0  0  0  0  0  0  0  0  0  0  0  0  0  0  0  0  0  0  0  0  0  0  0  0  0  0  0  0  0  0  0  0  0  0  0  0  0  0  0  0  0  0  0  0  0  0  0  0  0  0  0  0  0
 0  0  0  0  0  0  0  0  0  0  0  0  0  0  0  0  0  0  0  0  0  0  0  0  0  0  0  0  0  0  0  0  0  0  0  0  0  0  0  0  0  0  0  0  0  0  0  0  0  0  0  0  0  0  0  0  0  0  0  0  0  0  0  0  0  0  0  0  0  0  0  0  0  0  0
 0  0  0  0  0  0  0  0  0  0  0  0  0  0  0  0  0  0  0  0  0  0  0  0  0  0  0  0  0  0  0  0  0  0  0  0  0  0  0  0  0  0  0  0  0  0  0  0  0  0  0  0  0  0  0  0  0  0  0  0  0  0  0  0  0  0  0  0  0  0  0  0  0  0  0
 0  0  0  10  10  10  10  10  10  10  10  10  10  10  10  10  10  10  10  10  0  0  0  0  0  0  0  0  0  0  0  0  0  10  10  10  10  10  10  10  10  10  10  10  0  0  0  0  0  0  0  0  0  0  0  0  0  0  0  10  10  10  10  10  10  10  10  10  10  10  10  10  10  10  0
 0  0  0  10  10  10  10  10  10  10  10  10  10  10  10  10  10  10  10  10  0  0  0  0  0  0  0  0  0  0  0  0  0  10  10  10  10  10  10  10  10  10  10  10  10  10  0  0  0  0  0  0  0  0  0  0  0  0  0  10  10  10  10  10  10  10  10  10  10  10  10  10  10  10  0
 0  0  0  10  10  10  21  21  21  10  10  10  21  21  21  10  10  10  10  10  0  0  0  0  0  0  0  0  0  0  0  10  10  10  10  10  21  21  21  21  21  10  10  10  10  10  10  0  0  0  0  0  0  0  0  0  0  0  0  10  10  10  21  21  21  21  21  21  21  21  21  10  10  10  0
 0  0  0  10  10  10  10  10  10  10  10  10  10  10  10  10  10  10  10  10  0  0  0  0  0  0  0  0  0  0  0  10  10  10  10  10  10  21  21  21  0  10  10  10  10  10  10  0  0  0  0  0  0  0  0  0  0  0  0  10  10  10  10  10  10  10  10  10  10  10  10  10  10  10  0
 0  0  0  10  10  10  10  10  10  10  10  10  10  10  10  10  10  10  10  10  0  0  0  0  0  0  0  0  0  0  0  10  10  10  10  10  10  10  10  10  10  10  10  10  10  10  10  0  0  0  0  0  0  0  0  0  0  0  0  10  10  10  10  10  10  10  10  10  10  10  10  10  10  10  0
 0  0  0  10  10  10  10  10  10  10  10  10  10  10  10  10  10  10  10  10  10  10  10  10  10  10  10  10  10  10  10  10  10  10  10  10  10  10  10  10  10  10  10  10  10  10  10  10  10  10  10  10  10  10  10  10  10  10  10  10  10  10  10  10  10  21  21  21  10  0  0  10  10  10  0
 0  0  0  10  10  10  10  10  10  10  10  10  10  10  10  10  10  10  10  10  10  10  10  10  10  10  10  10  10  10  10  10  10  10  10  10  10  10  0  0  0  0  0  10  10  10  10  10  10  10  10  10  10  10  10  10  10  10  10  10  10  10  10  10  10  21  21  21  10  0  0  10  10  10  0
 0  0  0  10  10  10  10  10  10  10  10  10  10  10  10  10  10  10  10  10  10  10  10  10  10  10  10  10  10  10  10  10  10  10  10  10  10  10  0  0  0  0  0  10  10  10  10  10  10  10  10  10  10  10  10  10  10  10  10  10  10  10  21  21  10  10  10  10  10  21  21  10  10  10  0
 0  0  0  10  10  10  21  21  21  10  10  10  21  21  21  10  10  10  10  10  10  10  10  10  10  10  10  10  10  10  10  10  10  10  10  10  10  10  0  0  0  0  0  10  10  10  10  10  10  10  10  10  10  10  10  10  10  10  10  10  10  10  10  10  10  10  10  10  10  0  0  10  10  10  0
 0  0  0  10  10  10  10  10  10  10  10  10  10  10  10  10  10  10  10  10  10  10  10  10  10  10  10  10  10  10  10  10  10  10  10  10  10  10  0  0  0  0  0  10  10  10  10  10  10  10  10  10  10  10  10  10  10  10  10  10  10  10  10  10  10  10  10  10  10  0  0  10  10  10  0
 0  0  0  10  10  10  10  10  10  10  10  10  10  10  10  10  10  10  10  10  10  10  10  10  10  10  10  10  10  10  10  10  10  10  10  10  10  10  10  10  10  10  10  10  10  10  10  10  10  10  10  10  10  0  0  0  0  0  0  10  10  10  10  10  21  21  21  21  21  10  10  10  10  10  0
 0  0  0  10  10  10  10  10  10  10  10  10  10  10  10  10  10  10  10  10  0  0  0  0  0  0  0  0  0  0  0  10  10  10  10  10  10  10  10  10  10  10  10  10  10  10  10  10  0  0  0  0  0  0  0  0  0  0  0  0  10  10  10  10  10  10  10  10  10  10  10  10  10  10  0
 0  0  0  10  10  10  10  10  10  10  10  10  10  10  10  10  10  10  10  10  0  0  0  0  0  0  0  0  0  0  0  21  21  10  10  10  10  10  10  10  10  10  10  10  21  21  10  10  0  0  0  0  0  0  0  0  0  0  0  0  10  10  10  10  10  10  10  10  10  10  10  10  10  10  0
 0  0  0  10  10  10  10  10  10  10  10  10  10  10  10  10  10  10  10  10  0  0  0  0  0  0  0  0  0  0  0  0  10  10  10  10  10  10  10  10  10  10  10  10  10  10  0  0  0  0  0  0  0  0  0  0  0  0  0  10  10  10  10  10  10  10  10  10  10  10  10  10  10  10  0
 0  0  0  10  10  10  10  10  10  10  10  10  10  10  10  10  10  10  10  10  0  0  0  0  0  0  0  0  0  0  0  0  10  10  10  10  10  10  10  10  10  10  10  10  10  10  0  0  0  0  0  0  0  0  0  0  0  0  0  10  10  10  10  10  10  10  10  10  10  10  10  10  10  10  0
 0  0  0  10  10  10  10  10  10  10  10  10  10  10  10  10  0  0  0  0  0  0  0  0  0  0  0  0  0  0  0  0  0  0  10  10  10  10  10  10  10  10  10  10  10  0  0  0  0  0  0  0  0  0  0  0  0  0  0  0  0  0  0  0  0  0  0  0  0  0  0  0  0  0  0
 0  0  0  0  0  0  0  0  0  10  10  10  10  10  10  10  0  0  0  0  0  0  0  0  0  0  0  0  0  0  0  0  0  0  0  0  0  0  10  10  10  10  10  10  0  0  0  0  0  0  0  0  0  0  0  0  0  0  0  0  0  0  0  0  0  0  0  0  0  0  0  0  0  0  0
 0  0  0  0  0  0  0  0  0  10  10  10  10  10  10  10  0  0  0  0  0  0  0  0  0  0  0  0  0  0  0  0  0  0  0  0  0  0  10  10  10  10  10  10  0  0  0  0  0  0  0  0  0  0  0  0  0  0  0  0  0  0  0  0  0  0  0  0  0  0  0  0  0  0  0
 0  0  0  0  0  0  0  0  0  10  10  10  10  10  10  10  0  0  0  0  0  0  0  0  0  0  0  0  0  0  0  0  0  0  0  0  0  0  10  10  10  10  10  10  0  0  0  0  0  0  0  0  0  0  0  0  0  0  0  0  0  0  0  0  0  0  0  0  0  0  0  0  0  0  0
 0  0  0  0  0  0  0  0  0  10  10  10  10  10  10  10  0  0  0  0  0  0  0  0  0  0  0  0  0  0  0  0  0  0  0  0  0  0  10  10  10  10  10  10  0  0  0  0  0  0  0  0  0  0  0  0  0  0  0  0  0  0  0  0  0  0  0  0  0  0  0  0  0  0  0
 0  0  0  0  0  0  0  0  0  10  10  10  10  10  10  10  0  0  0  0  0  0  0  0  0  0  0  0  0  0  0  0  0  0  0  0  0  0  10  10  10  10  10  10  0  0  0  0  0  0  0  0  0  0  0  0  0  0  0  0  0  0  0  0  0  0  0  0  0  0  0  0  0  0  0
 0  0  0  0  0  0  0  0  0  10  10  10  10  10  10  10  0  0  0  0  0  0  0  0  0  0  0  0  0  0  0  0  0  0  0  0  0  0  10  10  10  10  10  10  0  0  0  0  0  0  0  0  0  0  0  0  0  0  0  0  0  0  0  0  0  0  0  0  0  0  0  0  0  0  0
 0  0  0  0  0  0  0  0  0  10  10  10  10  10  10  10  0  0  0  0  0  0  0  0  0  0  0  0  0  0  0  0  0  0  0  0  0  0  10  10  10  10  10  10  0  0  0  0  0  0  0  0  0  0  0  0  0  0  0  0  0  0  0  0  0  0  0  0  0  0  0  0  0  0  0
 0  0  0  0  0  0  0  0  0  10  10  10  10  10  10  10  0  0  0  0  0  0  0  0  0  0  0  0  0  0  0  0  0  0  0  0  0  0  10  10  10  10  10  10  0  0  0  0  0  0  0  0  0  0  0  0  0  0  0  0  0  0  0  0  0  0  0  0  0  0  0  0  0  0  0
 0  0  0  0  0  0  0  0  0  10  10  10  10  10  10  10  0  0  0  0  0  0  0  0  0  0  0  0  0  0  0  0  0  0  0  0  0  0  10  10  10  10  10  10  0  0  0  0  0  0  0  0  0  0  0  0  0  0  0  0  0  0  0  0  0  0  0  0  0  0  0  0  0  0  0
 0  0  0  0  0  0  0  0  0  10  10  10  10  10  10  10  0  0  0  0  0  0  0  0  0  0  0  0  0  0  0  0  0  0  0  0  0  10  10  10  10  10  10  10  0  0  0  0  0  0  0  0  0  0  0  0  0  0  0  0  0  0  0  0  0  0  0  0  0  0  0  0  0  0  0
 0  0  0  10  10  10  10  10  10  10  10  10  10  10  10  21  10  10  10  10  0  0  0  0  0  0  0  0  0  0  0  0  10  10  10  10  10  10  10  10  10  10  10  10  10  10  10  10  0  0  0  0  0  0  0  0  0  0  0  10  10  10  10  10  10  10  10  10  10  10  10  10  10  10  0
 0  0  0  10  10  10  10  10  10  10  10  10  10  10  21  10  21  10  10  10  0  0  0  0  0  0  0  0  0  0  0  0  10  10  10  10  10  10  10  10  10  10  10  10  10  10  10  10  0  0  0  0  0  0  0  0  0  0  0  10  10  10  10  10  10  10  10  10  10  10  10  10  10  10  0
 0  0  0  10  10  10  10  10  10  10  10  10  10  10  21  10  21  10  10  10  0  0  0  0  0  0  0  0  0  0  0  0  10  10  10  10  10  10  10  10  10  10  10  10  10  10  10  10  0  0  0  0  0  0  0  0  0  0  0  10  10  10  10  10  10  10  10  10  10  10  10  10  10  10  0
 0  0  0  10  10  10  10  10  10  10  10  10  10  10  10  10  10  10  10  10  0  0  0  0  0  0  0  0  0  0  0  0  10  10  10  10  10  10  10  10  10  10  10  10  10  10  10  10  0  0  0  0  0  0  0  0  0  0  0  10  10  10  10  10  10  10  10  10  10  10  10  10  10  10  0
 0  0  0  10  10  10  10  10  10  10  10  10  10  10  10  10  10  10  10  10  0  0  0  0  0  0  0  0  0  0  0  0  10  10  10  10  10  10  10  10  10  10  10  10  10  10  10  10  0  0  0  0  0  0  0  0  0  0  0  10  10  10  10  10  10  10  10  10  10  10  10  10  10  10  0
 0  0  0  10  10  10  10  10  10  10  10  10  10  10  10  10  10  10  10  10  0  0  0  0  0  0  0  0  0  0  0  0  10  10  10  10  10  10  10  0  0  0  0  0  0  0  0  0  0  10  10  10  10  10  10  10  10  10  10  10  10  10  10  10  10  10  10  10  10  10  10  10  10  10  0
 0  0  0  10  10  10  10  10  21  21  21  21  10  10  10  10  10  10  10  10  0  0  0  0  0  0  0  0  0  0  0  10  10  10  10  10  10  10  10  10  10  10  10  10  10  10  10  10  10  10  10  10  10  10  10  10  10  10  10  10  10  10  10  10  10  10  10  10  10  10  10  0  0
 0  0  0  10  10  10  10  10  10  10  10  0  0  0  10  10  10  10  10  10  10  0  0  0  0  0  0  0  0  0  0  10  10  10 10  10  10  10  10  10  10  10  10  10  10  10  10  10  10  10  10  10  10  10  10  10  10  10  10  10  10  10  10  10  10  10  10  10  10  35  35  10  10  10  0
 0  0  0  10  10  10  10  10  10  10  10  0  0  0  10  10  10  10  10  10  10  0  0  0  0  0  0  0  0  0  0  10  10  10  10  10  10  10  10  10  10  10  10  10  10  10  10  10  10  10  10  10  10  10  10  10  10  10  10  10  10  10  10  10  10  10  10  10  35  35  35  10  10  10  10  0
 0  0  0  10  10  10  10  10  10  10  10  0  0  0  10  10  10  10  10  10  10  0  0  0  0  0  0  0  0  0  0  10  10  10  10  10  10  10  10  10  10  10  10  10  10  10  10  10  10  10  10  10  10  10  10  10  10  10  10  10  10  10  10  10  10  10  10  10  35  35 35  10  10  10  10  0
 0  0  0  10  10  10  10  10  10  10  10  10  10  10  10  10  10  10  10  10  0  0  0  0  0  0  0  0  0  0  0  10  10  10  10  10  10  10  10  10  10  10  10  10  10  10  10  10  10  10  10  10  10  10  10  10  10  10  10  10  10  10  10  10  10  10  10  10  10  10  10  10  10  10  10  10  10 10  0
 0  0  0  10  10  10  10  10  10  10  10  10  10  10  10  10  10  10  10  10  0  0  0  0  0  0  0  0  0  0  0  10  10  10  10  10  10  10  10  10  10  10  10  10  10  10  10  10  10  0  0  0  0  0  0  0  0  0  0  10  10  10  10  10  10  10  10  10  10  10  10  10  10  10  10 
 0  0  0  10  10  10  10  10  10  10  10  10  10  10  10  10  10  0  0  0  0  0  0  0  0  0  0  0  0  0  10  10  10  10  10  10  10  10  10  10  10  10  10  10  10  10  10  0  0  0  0  0  0  0  0  0  0  0  0  10  10  10  10  10  10  10  10  10  10  10  10  10  10  10  10
 0  0  0  10  10  10  10  10  10  10  10  10  10  10  10  10  10  0  0  0  0  0  0  0  0  0  0  0  0  0  10  10  10  10  10  10  10  10  10  10  10  10  10  10  10  10  10  0  0  0  0  0  0  0  0  0  0  0  0  10  10  10  10  10  10  10  10  10  10  10  10  10  10  10  10
 0  0  0  10  10  10  10  10  10  10  10  10  10  10  10  10  10  0  0  0  0  0  0  0  0  0  0  0  0  0  10  10  10  10  10  10  10  10  10  10  10  10  10  10  10  10  10  0  0  0  0  0  0  0  0  0  0  0  0  10  10  10  10  10  10  10  10  10  10  10  10  10  10  10  10
 0  0  0  10  10  10  10  10  10  10  10  10  10  10  10  10  10  0  0  0  0  0  0  0  0  0  0  0  0  0  10  10  10  10  10  10  10  10  10  10  10  10  10  10  10  10  0  0  0  0  0  0  0  0  0  0  0  0  0  10  10  10  10  10  10  10  10  10  10  10  10  10  10  10  10
 0  0  0  10  10  10  10  10  10  10  10  10  10  10  10  10  10  0  0  0  0  0  0  0  0  0  0  0  0  0  10  10  10  10  10  10  10  10  10  10  10  10  10  10  10  10  0  0  0  0  0  0  0  0  0  0  0  0  0  10  10  10  10  10  10  10  10  10  10  10  10  10  10  10  0
 0  0  0  0  0  0  0  0  0  0  0  0  0  0  0  0  0  0  0  0  0  0  0  0  0  0  0  0  0  0  0  0  0  0  0  0  0  0  0  0  0  0  0  0  0  0  0  0  0  0  0  0  0  0  0  0  0  0  0  0  0  0  0  0  0  0  0  0  0  0  0  0  0  0  0  0  0  0  0
 